5 3 3 3 3 3 3 3 3 3 3 5
3 1 1 1 1 1 1 1 1 1 1 3
3 1 1 1 1 1 1 1 1 1 1 3
3 1 1 1 1 1 1 1 1 1 1 3
3 1 1 1 1 1 1 1 1 1 1 3
3 1 1 1 1 3 3 2 1 1 1 3
3 1 1 1 1 3 3 1 0 1 1 3
3 1 1 1 1 1 1 1 1 1 1 3
3 1 1 1 1 1 1 1 1 1 1 3
3 1 1 1 1 1 1 1 1 1 1 3
3 1 1 1 1 1 1 1 1 1 1 3
5 3 3 3 3 3 3 3 3 3 3 5